administration - Verwaltung
affairs - Angelegenheiten
policy - eine bestimmte Politik
politics - Politik im Allgemeinen
politician - Politiker
domestic policy - Innenpolitik
foreign policy - Außenpolitik
(to) influence (sth/so) - (etw/jmd) beeinflussen
decision-making - Entscheidungsfindung
republic - Republik
monarchy - Monarchie
monarch - Monarch
dictatorship - Diktatur
to have a say in sth - ein Mitspracherecht bei etw haben
(to) vote - wählen, stimmen
universal suffrage - allgemeines Wahlrecht
adult citizen - volljähriger Bürger
(to be) eligible to vote - wahlberechtigt (sein)
(to) elect (so) - (jmd) wählen
representative - Vertreter im Parliament
(to) hold a general election - eine allgemeine Wahl abhalten
(to) go to the polling station - zum Wahllokal gehen
polling station - Wahllokal
to cast one's vote - seine Stimme abgeben
(to) go to the polls - zur Wahl gehen
ballot paper - Stimmzettel
ballot box - Wahlurne
polling booth - Wahlkabine
(to) have a landslide victory, win a landslide victory - einen überwältigenden Sieg erringen
(to) form a government - eine Regierung bilden
(to) have an overall majority - die absolute Mehrheit haben
parliamentary democracy - parlamentarische Demokratie
constitutional monarchy - konstitutionelle Monarchie
slim - gering
proportional representation - Verhältniswahlrecht
first-past-the-post system - Mehrheitswahlrecht
constituency - Wahlkreis
constituent - Wähler
Member of Parliament - Parlamentsabgeordnete
to stand down - zurücktreten
by-election - Nachwahl
successor - Nachfolger
precursor - Vorgänger
chamber - Kammer
House of Commons - Unterhaus
House of Lords - Oberhaus
electorate - Wählerschaft
(to) appoint so to a post - (jmd) ernennen, in ein Amt einberufen
Chancellor of the Exchequer - Finanzminister
Foreign Secretary - Außenminister
Home Secretary - Innenminister
supporter - Anhänger
Speaker - Vorsitzende des Unterhauses
(to) preside over (sth) - (etw.) leiten, den Vorsitz (bei etw.) haben
(to) stay in office - im Amt bleiben
(to) call an election - zur Wahl aufrufen
(to) dissolve Parliament - das Parlament auflösen
peer - Mitglied des Oberhauses
Lords Spiritual - geistliche Mitglieder des Oberhauses
Law Lords - Mitglieder des Oberhauses mit richterlicher Funktion
judge - Richter
Lords Temporal - weltliche Mitglieder des Oberhauses
lay - Laien
Act of Parliament - verabschiedetes Gesetz
life peer - Mitglied des Oberhauses auf Lebenszeit
(to) create so a peer - jmd zum Peer ernennen
hereditary - Mitglied des Oberhauses mit erblichem Titel
(to) amend a bill - eine Gesetzesvorlage ändern
(to) draw up a bill - eine Gesetzesvorlage entwerfen
(to) veto a bill - Veto gegen eine Gesetzesvorlage einlegen
(to) delay (sth) - (etw) verschieben, verzögern
consent - Zustimmung
(to) consent to (sth) - (etw) zustimmen
taxation - Besteuerung
tax - Steuer
Lord Chancellor - Präsident des Oberhauses und Justizminister
head of the judiciary - Oberhaupt des Gerichtswesens
whip - parlamentarische Geschäftsführer
(to) maintain (sth) - (etw) aufrechterhalten
discipline - Disziplin
(to) keep (sb) up-to-date - (jmd) auf dem Laufenden halten
(to) toe the party line - (sich) nach der Parteilinie richten
issue - Frage, Angelegenheit
civil service - Staatsdienst
administrative staff - Verwaltungspersonal
civil servant - Staatsbeamter